GGGGGGGGGGGGGGGGGGGGGGGGGGGGGGGGBBBBBBBBBBBBBBBBBBBBBBBBBBBBBBBB
GFFFFFFFFFFFFFFFFFFFFFFFFFFFFFGFFBFFFFFFFFFFFFFFFFFFFFFFFFFFFFFB
GFFFFFFFFFFFFFFFFFFFFFFFFFFFFGFFFFBFFFFFFFFFFFFFFFFFFFFFFFFFFFFB
GFFFFFFFFFFFFFFFFFFFFFFFFFFFGFFFFFFBFFFFFFFFFFFFFFFFFFFFFFFFFFFB
GFFFFFFFFFFFFFFFFFFFFFFFFFFGFFFFFFFFBFFFFFFFFFFFFFFFFFFFFFFFFFFB
GFFFFFFFFFFFFFFFFFFFFFFFFFGFFFFFFFFFFBFFFFFFFFFFFFFFFFFFFFFFFFFB
GFFFFFFFFFFFFFFFFFFFFFFFFGFFFFFFFFFFFFBFFFFFFFFFFFFFFFFFFFFFFFFB
GFFFFFFFFFFFFFFFFFFFFFFFGFFFFFFFFFFFFFFBFFFFFFFFFFFFFFFFFFFFFFFB
GFFFFFFFFFFFFFFFFFFFFFFGFFFFFFFFFFFFFFFFBFFFFFFFFFFFFFFFFFFFFFFB
GFFFFFFFFFFFFFFFFFFFFFGFFFFFFFFFFFFFFFFFFBFFFFFFFFFFFFFFFFFFFFFB
GFFFFFFFFFFFFFFFFFFFFGFFFFFFFFFFFFFFFFFFFFBFFFFFFFFFFFFFFFFFFFFB
GFFFFFFFFFFFFFFFFFFFGFFFFFFFFFFFFFFFFFFFFFFBFFFFFFFFFFFFFFFFFFFB
GFFFFFFFFFFFFFFFFFFGFFFFFFFFFFFFFFFFFFFFFFFFBFFFFFFFFFFFFFFFFFFB
GFFFFFFFFFFFFFFFFFGFFFFFFFFFFFFFFFFFFFFFFFFFFBFFFFFFFFFFFFFFFFFB
GFFFFFFFFFFFFFFFFGFFFFFFFFFFFFFFFFFFFFFFFFFFFFBFFFFFFFFFFFFFFFFB
GFFFFFFFFFFFFFFFGFFFFFFFFFFFFFFFFFFFFFFFFFFFFFFBFFFFFFFFFFFFFFFB
GFFFFFFFFFFFFFFGFFFFFFFFFFFFFFFFFFFFFFFFFFFFFFFFBFFFFFFFFFFFFFFB
GFFFFFFFFFFFFFGFFFFFFFFFFFFFFFFFFFFFFFFFFFFFFFFFFBFFFFFFFFFFFFFB
GFFFFFFFFFFFFGFFFFFFFFFFFFFFFFFFFFFFFFFFFFFFFFFFFFBFFFFFFFFFFFFB
GFFFFFFFFFFFGFFFFFFFFFFFFFFFFFFFFFFFFFFFFFFFFFFFFFFBFFFFFFFFFFFB
GFFFFFFFFFFGFFFFFFFFFFFFFFFFFFFFFFFFFFFFFFFFFFFFFFFFBFFFFFFFFFFB
GFFFFFFFFFGFFFFFFFFFFFFFFFFFFFFFFFFFFFFFFFFFFFFFFFFFFBFFFFFFFFFB
GFFFFFFFFGFFFFFFFFFFFFFFFFFFFFFFFFFFFFFFFFFFFFFFFFFFFFBFFFFFFFFB
GFFFFFFFGFFFFFFFFFFFFFFFFFFFFFFFFFFFFFFFFFFFFFFFFFFFFFFBFFFFFFFB
GFFFFFFGFFFFFFFFFFFFFFFFFFFFFFFFFFFFFFFFFFFFFFFFFFFFFFFFBFFFFFFB
GFFFFFGFFFFFFFFFFFFFFFFFFFFFFFFFFFFFFFFFFFFFFFFFFFFFFFFFFBFFFFFB
GFFFFGFFFFFFFFFFFFFFFFFFFFFFFFFFFFFFFFFFFFFFFFFFFFFFFFFFFFBFFFFB
GFFFGFFFFFFFFFFFFFFFFFFFFFFFFFFFFFFFFFFFFFFFFFFFFFFFFFFFFFFBFFFB
GFFGFFFFFFFFFFFFFFFFFFFFFFFFFFFFFFFFFFFFFFFFFFFFFFFFFFFFFFFFBFFB
GFGFFFFFFFFFFFFFFFFFFFFFFFFFFFFFFFFFFFFFFFFFFFFFFFFFFFFFFFFFFBFB
GGFFFFFFFFFFFFFFFFFFFFFFFFFFFFFFFFFFFFFFFFFFFFFFFFFFFFFFFFFFFFBB
GFFFFFFFFFFFFFFFFFFFFFFFFFFFFFFFFFFFFFFFFFFFFFFFFFFFFFFFFFFFFFFB
BFFFFFFFFFFFFFFFFFFFFFFFFFFFFFFFFFFFFFFFFFFFFFFFFFFFFFFFFFFFFFFG
BBFFFFFFFFFFFFFFFFFFFFFFFFFFFFFFFFFFFFFFFFFFFFFFFFFFFFFFFFFFFFGG
BFBFFFFFFFFFFFFFFFFFFFFFFFFFFFFFFFFFFFFFFFFFFFFFFFFFFFFFFFFFFGFG
BFFBFFFFFFFFFFFFFFFFFFFFFFFFFFFFFFFFFFFFFFFFFFFFFFFFFFFFFFFFGFFG
BFFFBFFFFFFFFFFFFFFFFFFFFFFFFFFFFFFFFFFFFFFFFFFFFFFFFFFFFFFGFFFG
BFFFFBFFFFFFFFFFFFFFFFFFFFFFFFFFFFFFFFFFFFFFFFFFFFFFFFFFFFGFFFFG
BFFFFFBFFFFFFFFFFFFFFFFFFFFFFFFFFFFFFFFFFFFFFFFFFFFFFFFFFGFFFFFG
BFFFFFFBFFFFFFFFFFFFFFFFFFFFFFFFFFFFFFFFFFFFFFFFFFFFFFFFGFFFFFFG
BFFFFFFFBFFFFFFFFFFFFFFFFFFFFFFFFFFFFFFFFFFFFFFFFFFFFFFGFFFFFFFG
BFFFFFFFFBFFFFFFFFFFFFFFFFFFFFFFFFFFFFFFFFFFFFFFFFFFFFGFFFFFFFFG
BFFFFFFFFFBFFFFFFFFFFFFFFFFFFFFFFFFFFFFFFFFFFFFFFFFFFGFFFFFFFFFG
BFFFFFFFFFFBFFFFFFFFFFFFFFFFFFFFFFFFFFFFFFFFFFFFFFFFGFFFFFFFFFFG
BFFFFFFFFFFFBFFFFFFFFFFFFFFFFFFFFFFFFFFFFFFFFFFFFFFGFFFFFFFFFFFG
BFFFFFFFFFFFFBFFFFFFFFFFFFFFFFFFFFFFFFFFFFFFFFFFFFGFFFFFFFFFFFFG
BFFFFFFFFFFFFFBFFFFFFFFFFFFFFFFFFFFFFFFFFFFFFFFFFGFFFFFFFFFFFFFG
BFFFFFFFFFFFFFFBFFFFFFFFFFFFFFFFFFFFFFFFFFFFFFFFGFFFFFFFFFFFFFFG
BFFFFFFFFFFFFFFFBFFFFFFFFFFFFFFFFFFFFFFFFFFFFFFGFFFFFFFFFFFFFFFG
BFFFFFFFFFFFFFFFFBFFFFFFFFFFFFFFFFFFFFFFFFFFFFGFFFFFFFFFFFFFFFFG
BFFFFFFFFFFFFFFFFFBFFFFFFFFFFFFFFFFFFFFFFFFFFGFFFFFFFFFFFFFFFFFG
BFFFFFFFFFFFFFFFFFFBFFFFFFFFFFFFFFFFFFFFFFFFGFFFFFFFFFFFFFFFFFFG
BFFFFFFFFFFFFFFFFFFFBFFFFFFFFFFFFFFFFFFFFFFGFFFFFFFFFFFFFFFFFFFG
BFFFFFFFFFFFFFFFFFFFFBFFFFFFFFFFFFFFFFFFFFGFFFFFFFFFFFFFFFFFFFFG
BFFFFFFFFFFFFFFFFFFFFFBFFFFFFFFFFFFFFFFFFGFFFFFFFFFFFFFFFFFFFFFG
BFFFFFFFFFFFFFFFFFFFFFFBFFFFFFFFFFFFFFFFGFFFFFFFFFFFFFFFFFFFFFFG
BFFFFFFFFFFFFFFFFFFFFFFFBFFFFFFFFFFFFFFGFFFFFFFFFFFFFFFFFFFFFFFG
BFFFFFFFFFFFFFFFFFFFFFFFFBFFFFFFFFFFFFGFFFFFFFFFFFFFFFFFFFFFFFFG
BFFFFFFFFFFFFFFFFFFFFFFFFFBFFFFFFFFFFGFFFFFFFFFFFFFFFFFFFFFFFFFG
BFFFFFFFFFFFFFFFFFFFFFFFFFFBFFFFFFFFGFFFFFFFFFFFFFFFFFFFFFFFFFFG
BFFFFFFFFFFFFFFFFFFFFFFFFFFFBFFFFFFGFFFFFFFFFFFFFFFFFFFFFFFFFFFG
BFFFFFFFFFFFFFFFFFFFFFFFFFFFFBFFFFGFFFFFFFFFFFFFFFFFFFFFFFFFFFFG
BFFFFFFFFFFFFFFFFFFFFFFFFFFFFFBFFGFFFFFFFFFFFFFFFFFFFFFFFFFFFFFG
BBBBBBBBBBBBBBBBBBBBBBBBBBBBBBBBGGGGGGGGGGGGGGGGGGGGGGGGGGGGGGGG

