BBBBBBBBBBBBBBBBBBBBBBBBBBBBBBBBBBBBBBBBBBBBBBBBBBBBBBBBBBBBBBBB
GFFFFFFFFFFFFFFFFFFFFFFFFFFFFFFFFFFFFFFFFFFFFFFFFFFFFFFFFFFFFFFG
GFFFFFFFFFFFFFFFFFFFFFFFFFFFFFFRRFFFFFFFFFFFFFFFFFFFFFFFFFFFFFFG
GFFFFFFFFFFFFFFFFFFFFFFFFFFFFFRRRRFFFFFFFFFFFFFFFFFFFFFFFFFFFFFG
GFFFFFFFFFFFFFFFFFFFFFFFFFFFFRRRRRRFFFFFFFFFFFFFFFFFFFFFFFFFFFFG
GFFFFFFFFFFFFFFFFFFFFFFFFFFFRRRRRRRRFFFFFFFFFFFFFFFFFFFFFFFFFFFG
GFFFFFFFFFFFFFFFFFFFFFFFFFFRRRRKRRRRRFFFFFFFFFFFFFFFFFFFFFFFFFFG
GFFFFFFFFFFFFFFFFFFFFFFFFFRRRRKKKRRRRRFFFFFFFFFFFFFFFFFFFFFFFFFG
GFFFFFFFFFFFFFFFFFFFFFFFFRRRRKKKKKRRRRRFFFFFFFFFFFFFFFFFFFFFFFFG
GFFFFFFFFFFFFFFFFFFFFFFFRRRRKKKKKKKRRRRRFFFFFFFFFFFFFFFFFFFFFFFG
GFFFFFFFFFFFFFFFFFFFFFFRRRRKKKKKKKKKRRRRRFFFFFFFFFFFFFFFFFFFFFFG
GFFFFFFFFFFFFFFFFFFFFFRRRRKKKKKKKKKKKRRRRRFFFFFFFFFFFFFFFFFFFFFG
GFFFFFFFFFFFFFFFFFFFFRRRRKKKKKKKKKKKKKRRRRRFFFFFFFFFFFFFFFFFFFFG
GFFFFFFFFFFFFFFFFFFFRRRRKKKKKKKKKKKKKKKRRRRRFFFFFFFFFFFFFFFFFFFG
GFFFFFFFFFFFFFFFFFFRRRRKKKKKKKKKKKKKKKKKRRRRRFFFFFFFFFFFFFFFFFFG
GFFFFFFFFFFFFFFFFFRRRRKKKKKKKKKKKKKKKKKKKRRRRRFFFFFFFFFFFFFFFFFG
GFFFFFFFFFFFFFFFFRRRRKKKKKKKKKKKKKKKKKKKKKRRRRRFFFFFFFFFFFFFFFFG
GFFFFFFFFFFFFFFFSSRRKKKKKKKKKKKKKKKKKKKKKKKRRRYYFFFFFFFFFFFFFFFG
GFFFFFFFFFFFFFFSSSSKKKKKKKKKKKKKKKKKKKKKKKKKRYYYYFFFFFFFFFFFFFFG
GFFFFFFFFFFFFFSSSSAAKKKKKKKKKKKKKKKKKKKKKKKKVYYYYYFFFFFFFFFFFFFG
GFFFFFFFFFFFFSSSSAAAAKKKKKKKKKKKKKKKKKKKKKKVVVYYYYYFFFFFFFFFFFFG
GFFFFFFFFFFFSSSSAAAAAAKKKKKKKKKKKKKKKKKKKKVVVVVYYYYYFFFFFFFFFFFG
GFFFFFFFFFFSSSSAAAAAAAAKKKKKKKKKKKKKKKKKKVVVVVVVYYYYYFFFFFFFFFFG
GFFFFFFFFFSSSSAAAAAAAAAAKKKKKKKKKKKKKKKKVVVVVVVVVYYYYYFFFFFFFFFG
GFFFFFFFFSSSSAAAAAAAAAAAAKKKKKKKKKKKKKKVVVVVVVVVVVYYYYYFFFFFFFFG
GFFFFFFFSSSSAAAAAAAAAAAAAAKKKKKKKKKKKKVVVVVVVVVVVVVYYYYYFFFFFFFG
GFFFFFFSSSSAAAAAAAAAAAAAAAAKKKKKKKKKKVVVVVVVVVVVVVVVYYYYYFFFFFFG
GFFFFFSSSSAAAAAAAAAAAAAAAAAAKKKKKKKKVVVVVVVVVVVVVVVVVYYYYYFFFFFG
GFFFFSSSSAAAAAAAAAAAAAAAAAAAAKKKKKKVVVVVVVVVVVVVVVVVVVYYYYYFFFFG
GFFFSSSSAAAAAAAAAAAAAAAAAAAAAAKKKKVVVVVVVVVVVVVVVVVVVVVYYYYYFFFG
GFFSSSSAAAAAAAAAAAAAAAAAAAAAAAAKKVVVVVVVVVVVVVVVVVVVVVVVYYYYYFFG
GFSSSSAAAAAAAAAAAAAAAAAAAAAAAAAAVVVVVVVVVVVVVVVVVVVVVVVVVYYYYYFG
GFSSSSSAAAAAAAAAAAAAAAAAAAAAAAAOOVVVVVVVVVVVVVVVVVVVVVVVYYYYYYFG
GFFSSSSSAAAAAAAAAAAAAAAAAAAAAAOOOOVVVVVVVVVVVVVVVVVVVVVYYYYYYFFG
GFFFSSSSSAAAAAAAAAAAAAAAAAAAAOOOOOOVVVVVVVVVVVVVVVVVVVYYYYYYFFFG
GFFFFSSSSSAAAAAAAAAAAAAAAAAAOOOOOOOOVVVVVVVVVVVVVVVVVYYYYYYFFFFG
GFFFFFSSSSSAAAAAAAAAAAAAAAAOOOOOOOOOOVVVVVVVVVVVVVVVYYYYYYFFFFFG
GFFFFFFSSSSSAAAAAAAAAAAAAAOOOOOOOOOOOOVVVVVVVVVVVVVYYYYYYFFFFFFG
GFFFFFFFSSSSSAAAAAAAAAAAAOOOOOOOOOOOOOOVVVVVVVVVVVYYYYYYFFFFFFFG
GFFFFFFFFSSSSSAAAAAAAAAAOOOOOOOOOOOOOOOOVVVVVVVVVYYYYYYFFFFFFFFG
GFFFFFFFFFSSSSSAAAAAAAAOOOOOOOOOOOOOOOOOOVVVVVVVYYYYYYFFFFFFFFFG
GFFFFFFFFFFSSSSSAAAAAAOOOOOOOOOOOOOOOOOOOOVVVVVYYYYYYFFFFFFFFFFG
GFFFFFFFFFFFSSSSSAAAAOOOOOOOOOOOOOOOOOOOOOOVVVYYYYYYFFFFFFFFFFFG
GFFFFFFFFFFFFSSSSSAAOOOOOOOOOOOOOOOOOOOOOOOOVYYYYYYFFFFFFFFFFFFG
GFFFFFFFFFFFFFSSSSSOOOOOOOOOOOOOOOOOOOOOOOOOPYYYYYFFFFFFFFFFFFFG
GFFFFFFFFFFFFFFSSSPPOOOOOOOOOOOOOOOOOOOOOOOPPPYYYFFFFFFFFFFFFFFG
GFFFFFFFFFFFFFFFSPPPPOOOOOOOOOOOOOOOOOOOOOPPPPPYFFFFFFFFFFFFFFFG
GFFFFFFFFFFFFFFFFPPPPPOOOOOOOOOOOOOOOOOOOPPPPPPFFFFFFFFFFFFFFFFG
GFFFFFFFFFFFFFFFFFPPPPPOOOOOOOOOOOOOOOOOPPPPPPFFFFFFFFFFFFFFFFFG
GFFFFFFFFFFFFFFFFFFPPPPPOOOOOOOOOOOOOOOPPPPPPFFFFFFFFFFFFFFFFFFG
GFFFFFFFFFFFFFFFFFFFPPPPPOOOOOOOOOOOOOPPPPPPFFFFFFFFFFFFFFFFFFFG
GFFFFFFFFFFFFFFFFFFFFPPPPPOOOOOOOOOOOPPPPPPFFFFFFFFFFFFFFFFFFFFG
GFFFFFFFFFFFFFFFFFFFFFPPPPPOOOOOOOOOPPPPPPFFFFFFFFFFFFFFFFFFFFFG
GFFFFFFFFFFFFFFFFFFFFFFPPPPPOOOOOOOPPPPPPFFFFFFFFFFFFFFFFFFFFFFG
GFFFFFFFFFFFFFFFFFFFFFFFPPPPPOOOOOPPPPPPFFFFFFFFFFFFFFFFFFFFFFFG
GFFFFFFFFFFFFFFFFFFFFFFFFPPPPPOOOPPPPPPFFFFFFFFFFFFFFFFFFFFFFFFG
GFFFFFFFFFFFFFFFFFFFFFFFFFPPPPPOPPPPPPFFFFFFFFFFFFFFFFFFFFFFFFFG
GFFFFFFFFFFFFFFFFFFFFFFFFFFPPPPPPPPPPFFFFFFFFFFFFFFFFFFFFFFFFFFG
GFFFFFFFFFFFFFFFFFFFFFFFFFFFPPPPPPPPFFFFFFFFFFFFFFFFFFFFFFFFFFFG
GFFFFFFFFFFFFFFFFFFFFFFFFFFFFPPPPPPFFFFFFFFFFFFFFFFFFFFFFFFFFFFG
GFFFFFFFFFFFFFFFFFFFFFFFFFFFFFPPPPFFFFFFFFFFFFFFFFFFFFFFFFFFFFFG
GFFFFFFFFFFFFFFFFFFFFFFFFFFFFFFPPFFFFFFFFFFFFFFFFFFFFFFFFFFFFFFG
GFFFFFFFFFFFFFFFFFFFFFFFFFFFFFFFFFFFFFFFFFFFFFFFFFFFFFFFFFFFFFFG
GBBBBBBBBBBBBBBBBBBBBBBBBBBBBBBBBBBBBBBBBBBBBBBBBBBBBBBBBBBBBBBB
