BBBBBBBBBBBBBBBBBBBBBBBBBBBBBBBBBBBBBBBBBBBBBBBBBBBBBBBBBBBBBBBB
GMMMMMMMMMMMMMMMMMMMMMMMMMMMMMMMMMMMMMMMMMMMMMMFFFFFFFFFFFFFFFFG
GMMMMMMMMMMMMMMMMMMMMMMMMMMMMMMMMMMMMMMMMMMMMMMFFFFFFFFFFFFFFFFG
GMMMMMMMMMMMMMMMMMMMMMMMMMMMMMMMMMMMMMMMMMMMMMMFFFFFFFFFFFFFFFFG
GMMMVVVVVVVVVVVVVVVVVVVVVVVVVVVVVVVVVVVVVVVMMMMFFFFFFFFFFFFFFFFG
GMMMVVVVVVVVVVVVVVVVVVVVVVVVVVVVVVVVVVVVVVVMMMMFFFFFFFFFFFFFFFFG
GMMMVVVVVVVVVVVVVVVVVVVVVVVVVVVVVVVVVVVVVVVMMMMFFFFFFFFFFFFFFFFG
GMMMVVVVVVVVVVVVVVVVVVVVVVVVVVVVVVVVVVVVVVVMMMMFFFFFFFFFFFFFFFFG
GMMMVVVVVVVVVVVVVVVVVVVVVVVVVVVVVVVVVVVVVVVMMMMFFFFFFFFFFFFFFFFG
GMMMVVVVVVVVVVVVVVVVVVVVVVVVVVVVVVVVVVVVVVVMMMMFFFFFFFFFFFFFFFFG
GMMMVVVVVVVVVVVVVVVVVVVVVVVVVVVVVVVVVVVVVVVMMMMFFFFFFFFFFFFFFFFG
GMMMVVVVVVVVVVVVVVVVVVVVVVVVVVVVVVVVVVVVVVVMMMMFFFFFFFFFFFFFFFFG
GMMMVVVVVVVVVVVVVVVVVVVVVVVVVVVVVVVVVVVVVVVMMMMFFFFFFFFFFFFFFFFG
GMMMVVVVVVVVVVVVVVVVVVVVVVVVVVVVVVVVVVVVVVVMMMMFFFFFFFFFFFFFFFFG
GMMMVVVVVVVVVVVVVVVVVVVVVVVVVVVVVVVVVVVVVVVMMMMFFFFFFFFFFFFFFFFG
GMMMVVVVVVVVVVVVVVVVVVVVVVVVVVVVVVVVVVVVVVVMMMMFFFFFFFFFFFFFFFFG
GMMMVVVVVVVVVVVVVVVVVVVVVVVVVVVVVVVVVVVVVVVMMMMFFFFFFFFFFFFFFFFG
GMMMVVVVVVVVVVVVVVVVVVVVVVVVVVVVVVVVVVVVVVVMMMAFFFFFFFFFFFFFFFFG
GMMMVVVVVVVVVVVVVVVVVVVVVVVVVVVVVVVVVVVVVVVMMAAFFFFFFFFFFFFFFFFG
GMMMVVVVVVVVVVVVVVVVVVVVVVVVVVVVVVVVVVVVVVVMAAAFFFFFFFFFFFFFFFFG
GMMMVVVVVVVVVVVVVVVVVVVVVVVVVVVVVVVVVVVVVVVAAAAFFFFFFFFFFFFFFFFG
GMMMVVVVVVVVVVVVVVVVVVVVVVVVVVVVVVVVVVVVVVSAAAAFFFFFFFFFFFFFFFFG
GMMMVVVVVVVVVVVVVVVVVVVVVVVVVVVVVVVVVVVVVSSAAAAFFFFFFFFFFFFFFFFG
GMMMVVVVVVVVVVVVVVVVVVVVVVVVVVVVVVVVVVVVSSSAAAAFFFFFFFFFFFFFFFFG
GMMMVVVVVVVVVVVVVVVVVVVVVVVVVVVVVVVVVVVSSSSAAAAFFFFFFFFFFFFFFFFG
GMMMVVVVVVVVVVVVVVVVVVVVVVVVVVVVVVVVVVSSSSSAAAAFFFFFFFFFFFFFFFFG
GMMMVVVVVVVVVVVVVVVVVVVVVVVVVVVVVVVVVSSSSSSAAAAFFFFFFFFFFFFFFFFG
GMMMVVVVVVVVVVVVVVVVVVVVVVVVVVVVVVVVSSSSSSSAAAAFFFFFFFFFFFFFFFFG
GMMMVVVVVVVVVVVVVVVVVVVVVVVVVVVVVVVSSSSSSSSAAAAFFFFFFFFFFFFFFFFG
GMMMVVVVVVVVVVVVVVVVVVVVVVVVVVVVVVSSSSSSSSSAAAAFFFFFFFFFFFFFFFFG
GMMMVVVVVVVVVVVVVVVVVVVVVVVVVVVVVSSSSSSSSSSAAAAFFFFFFFFFFFFFFFFG
GMMMVVVVVVVVVVVVVVVVVVVVVVVVVVVVSSSSSSSSSSSAAAAFFFFFFFFFFFFFFFFG
GMMMVVVVVVVVVVVVVVVVVVVVVVVVVVVSSSSSSSSSSSSAAAAFFFFFFFFFFFFFFFFG
GMMMVVVVVVVVVVVVVVVVVVVVVVVVVVSSSSSSSSSSSSSAAAAFFFFFFFFFFFFFFFFG
GMMMVVVVVVVVVVVVVVVVVVVVVVVVVSSSSSSSSSSSSSSAAAAFFFFFFFFFFFFFFFFG
GMMMVVVVVVVVVVVVVVVVVVVVVVVVSSSSSSSSSSSSSSSAAAAFFFFFFFFFFFFFFFFG
GMMMVVVVVVVVVVVVVVVVVVVVVVVSSSSSSSSSSSSSSSSAAAAFFFFFFFFFFFFFFFFG
GMMMVVVVVVVVVVVVVVVVVVVVVVSSSSSSSSSSSSSSSSSAAAAFFFFFFFFFFFFFFFFG
GMMMVVVVVVVVVVVVVVVVVVVVVSSSSSSSSSSSSSSSSSSAAAAFFFFFFFFFFFFFFFFG
GMMMVVVVVVVVVVVVVVVVVVVVSSSSSSSSSSSSSSSSSSSAAAAFFFFFFFFFFFFFFFFG
GMMMVVVVVVVVVVVVVVVVVVVSSSSSSSSSSSSSSSSSSSSAAAAFFFFFFFFFFFFFFFFG
GMMMVVVVVVVVVVVVVVVVVVSSSSSSSSSSSSSSSSSSSSSAAAAFFFFFFFFFFFFFFFFG
GMMMVVVVVVVVVVVVVVVVVSSSSSSSSSSSSSSSSSSSSSSAAAAFFFFFFFFFFFFFFFFG
GMMMVVVVVVVVVVVVVVVVSSSSSSSSSSSSSSSSSSSSSSSAAAAFFFFFFFFFFFFFFFFG
GMMMVVVVVVVVVVVVVVVSSSSSSSSSSSSSSSSSSSSSSSSAAAAFFFFFFFFFFFFFFFFG
GMMMVVVVVVVVVVVVVVSSSSSSSSSSSSSSSSSSSSSSSSSAAAAFFFFFFFFFFFFFFFFG
GMMMVVVVVVVVVVVVVSSSSSSSSSSSSSSSSSSSSSSSSSSAAAAFFFFFFFFFFFFFFFFG
GMMMVVVVVVVVVVVVSSSSSSSSSSSSSSSSSSSSSSSSSSSAAAAFFFFFFFFFFFFFFFFG
GMMMVVVVVVVVVVVSSSSSSSSSSSSSSSSSSSSSSSSSSSSAAAAFFFFFFFFFFFFFFFFG
GMMMVVVVVVVVVVSSSSSSSSSSSSSSSSSSSSSSSSSSSSSAAAAFFFFFFFFFFFFFFFFG
GMMMVVVVVVVVVSSSSSSSSSSSSSSSSSSSSSSSSSSSSSSAAAAFFFFFFFFFFFFFFFFG
GMMMVVVVVVVVSSSSSSSSSSSSSSSSSSSSSSSSSSSSSSSAAAAFFFFFFFFFFFFFFFFG
GMMMVVVVVVVSSSSSSSSSSSSSSSSSSSSSSSSSSSSSSSSAAAAFFFFFFFFFFFFFFFFG
GMMMVVVVVVSSSSSSSSSSSSSSSSSSSSSSSSSSSSSSSSSAAAAFFFFFFFFFFFFFFFFG
GMMMVVVVVSSSSSSSSSSSSSSSSSSSSSSSSSSSSSSSSSSAAAAFFFFFFFFFFFFFFFFG
GMMMVVVVSSSSSSSSSSSSSSSSSSSSSSSSSSSSSSSSSSSAAAAFFFFFFFFFFFFFFFFG
GMMMVVVSSSSSSSSSSSSSSSSSSSSSSSSSSSSSSSSSSSSAAAAFFFFFFFFFFFFFFFFG
GMMMVVSSSSSSSSSSSSSSSSSSSSSSSSSSSSSSSSSSSSSAAAAFFFFFFFFFFFFFFFFG
GMMMVSSSSSSSSSSSSSSSSSSSSSSSSSSSSSSSSSSSSSSAAAAFFFFFFFFFFFFFFFFG
GMMMAAAAAAAAAAAAAAAAAAAAAAAAAAAAAAAAAAAAAAAAAAAFFFFFFFFFFFFFFFFG
GMMAAAAAAAAAAAAAAAAAAAAAAAAAAAAAAAAAAAAAAAAAAAAFFFFFFFFFFFFFFFFG
GMAAAAAAAAAAAAAAAAAAAAAAAAAAAAAAAAAAAAAAAAAAAAAFFFFFFFFFFFFFFFFG
GAAAAAAAAAAAAAAAAAAAAAAAAAAAAAAAAAAAAAAAAAAAAAAFFFFFFFFFFFFFFFFG
GBBBBBBBBBBBBBBBBBBBBBBBBBBBBBBBBBBBBBBBBBBBBBBBBBBBBBBBBBBBBBBB
