BBBBBBBBBBBBBBBBBBBBBBBBBBBBBBBBBBBBBBBBBBBBBBBBBBBBBBBBBBBBBBBB
GRRRRRRRRRRRRRRRRRRRRRRRRRRRRRYYYFFFFFFFFFFFFFFFFFFFFFFFFFFFFFFG
GRRRRRRRRRRRRRRRRRRRRRRRRRRRRYYYYYFFFFFFFFFFFFFFFFFFFFFFFFFFFFFG
GRRRRRRRRRRRRRRRRRRRRRRRRRRRYYYYYYYFFFFFFFFFFFFFFFFFFFFFFFFFFFFG
GRRRKKKKKKKKKKKKKKKKKKKKKKKVVVVYYYYYFFFFFFFFFFFFFFFFFFFFFFFFFFFG
GRRRKKKKKKKKKKKKKKKKKKKKKKVVVVVVYYYYYFFFFFFFFFFFFFFFFFFFFFFFFFFG
GRRRKKKKKKKKKKKKKKKKKKKKKVVVVVVVVYYYYYFFFFFFFFFFFFFFFFFFFFFFFFFG
GRRRKKKKKKKKKKKKKKKKKKKKVVVVVVVVVVYYYYYFFFFFFFFFFFFFFFFFFFFFFFFG
GRRRKKKKKKKKKKKKKKKKKKKVVVVVVVVVVVVYYYYYFFFFFFFFFFFFFFFFFFFFFFFG
GRRRKKKKKKKKKKKKKKKKKKVVVVVVVVVVVVVVYYYYYFFFFFFFFFFFFFFFFFFFFFFG
GRRRKKKKKKKKKKKKKKKKKVVVVVVVVVVVVVVVVYYYYYFFFFFFFFFFFFFFFFFFFFFG
GRRRKKKKKKKKKKKKKKKKVVVVVVVVVVVVVVVVVVYYYYYFFFFFFFFFFFFFFFFFFFFG
GRRRKKKKKKKKKKKKKKKVVVVVVVVVVVVVVVVVVVVYYYYYFFFFFFFFFFFFFFFFFFFG
GRRRKKKKKKKKKKKKKKVVVVVVVVVVVVVVVVVVVVVVYYYYYFFFFFFFFFFFFFFFFFFG
GRRRKKKKKKKKKKKKKVVVVVVVVVVVVVVVVVVVVVVVVYYYYYFFFFFFFFFFFFFFFFFG
GRRRKKKKKKKKKKKKVVVVVVVVVVVVVVVVVVVVVVVVVVYYYYYFFFFFFFFFFFFFFFFG
GRRRKKKKKKKKKKKVVVVVVVVVVVVVVVVVVVVVVVVVVVVYYYYYFFFFFFFFFFFFFFFG
GRRRKKKKKKKKKKVVVVVVVVVVVVVVVVVVVVVVVVVVVVVVYYYYYFFFFFFFFFFFFFFG
GRRRKKKKKKKKKVVVVVVVVVVVVVVVVVVVVVVVVVVVVVVVVYYYYYFFFFFFFFFFFFFG
GRRRKKKKKKKKVVVVVVVVVVVVVVVVVVVVVVVVVVVVVVVVVVYYYYYFFFFFFFFFFFFG
GRRRKKKKKKKVVVVVVVVVVVVVVVVVVVVVVVVVVVVVVVVVVVVYYYYYFFFFFFFFFFFG
GRRRKKKKKKVVVVVVVVVVVVVVVVVVVVVVVVVVVVVVVVVVVVVVYYYYYFFFFFFFFFFG
GRRRKKKKKVVVVVVVVVVVVVVVVVVVVVVVVVVVVVVVVVVVVVVVVYYYYYFFFFFFFFFG
GRRRKKKKVVVVVVVVVVVVVVVVVVVVVVVVVVVVVVVVVVVVVVVVVVYYYYYFFFFFFFFG
GRRRKKKVVVVVVVVVVVVVVVVVVVVVVVVVVVVVVVVVVVVVVVVVVVVYYYYYFFFFFFFG
GRRRKKVVVVVVVVVVVVVVVVVVVVVVVVVVVVVVVVVVVVVVVVVVVVVVYYYYYFFFFFFG
GRRRKVVVVVVVVVVVVVVVVVVVVVVVVVVVVVVVVVVVVVVVVVVVVVVVVYYYYYFFFFFG
GRRRVVVVVVVVVVVVVVVVVVVVVVVVVVVVVVVVVVVVVVVVVVVVVVVVVVYYYYYFFFFG
GRRYVVVVVVVVVVVVVVVVVVVVVVVVVVVVVVVVVVVVVVVVVVVVVVVVVVVYYYYYFFFG
GRYYVVVVVVVVVVVVVVVVVVVVVVVVVVVVVVVVVVVVVVVVVVVVVVVVVVVVYYYYYFFG
GYYYVVVVVVVVVVVVVVVVVVVVVVVVVVVVVVVVVVVVVVVVVVVVVVVVVVVVVYYYYYFG
GYYYYVVVVVVVVVVVVVVVVVVVVVVVVVVVVVVVVVVVVVVVVVVVVVVVVVVVVVYYYYFG
GYYYYYVVVVVVVVVVVVVVVVVVVVVVVVVVVVVVVVVVVVVVVVVVVVVVVVVVVVVYYYFG
GFYYYYYVVVVVVVVVVVVVVVVVVVVVVVVVVVVVVVVVVVVVVVVVVVVVVVVVVVVYYYPG
GFFYYYYYVVVVVVVVVVVVVVVVVVVVVVVVVVVVVVVVVVVVVVVVVVVVVVVVVVVYYPPG
GFFFYYYYYVVVVVVVVVVVVVVVVVVVVVVVVVVVVVVVVVVVVVVVVVVVVVVVVVVYPPPG
GFFFFYYYYYVVVVVVVVVVVVVVVVVVVVVVVVVVVVVVVVVVVVVVVVVVVVVVVVVPPPPG
GFFFFFYYYYYVVVVVVVVVVVVVVVVVVVVVVVVVVVVVVVVVVVVVVVVVVVVVVVOPPPPG
GFFFFFFYYYYYVVVVVVVVVVVVVVVVVVVVVVVVVVVVVVVVVVVVVVVVVVVVVOOPPPPG
GFFFFFFFYYYYYVVVVVVVVVVVVVVVVVVVVVVVVVVVVVVVVVVVVVVVVVVVOOOPPPPG
GFFFFFFFFYYYYYVVVVVVVVVVVVVVVVVVVVVVVVVVVVVVVVVVVVVVVVVOOOOPPPPG
GFFFFFFFFFYYYYYVVVVVVVVVVVVVVVVVVVVVVVVVVVVVVVVVVVVVVVOOOOOPPPPG
GFFFFFFFFFFYYYYYVVVVVVVVVVVVVVVVVVVVVVVVVVVVVVVVVVVVVOOOOOOPPPPG
GFFFFFFFFFFFYYYYYVVVVVVVVVVVVVVVVVVVVVVVVVVVVVVVVVVVOOOOOOOPPPPG
GFFFFFFFFFFFFYYYYYVVVVVVVVVVVVVVVVVVVVVVVVVVVVVVVVVOOOOOOOOPPPPG
GFFFFFFFFFFFFFYYYYYVVVVVVVVVVVVVVVVVVVVVVVVVVVVVVVOOOOOOOOOPPPPG
GFFFFFFFFFFFFFFYYYYYVVVVVVVVVVVVVVVVVVVVVVVVVVVVVOOOOOOOOOOPPPPG
GFFFFFFFFFFFFFFFYYYYYVVVVVVVVVVVVVVVVVVVVVVVVVVVOOOOOOOOOOOPPPPG
GFFFFFFFFFFFFFFFFYYYYYVVVVVVVVVVVVVVVVVVVVVVVVVOOOOOOOOOOOOPPPPG
GFFFFFFFFFFFFFFFFFYYYYYVVVVVVVVVVVVVVVVVVVVVVVOOOOOOOOOOOOOPPPPG
GFFFFFFFFFFFFFFFFFFYYYYYVVVVVVVVVVVVVVVVVVVVVOOOOOOOOOOOOOOPPPPG
GFFFFFFFFFFFFFFFFFFFYYYYYVVVVVVVVVVVVVVVVVVVOOOOOOOOOOOOOOOPPPPG
GFFFFFFFFFFFFFFFFFFFFYYYYYVVVVVVVVVVVVVVVVVOOOOOOOOOOOOOOOOPPPPG
GFFFFFFFFFFFFFFFFFFFFFYYYYYVVVVVVVVVVVVVVVOOOOOOOOOOOOOOOOOPPPPG
GFFFFFFFFFFFFFFFFFFFFFFYYYYYVVVVVVVVVVVVVOOOOOOOOOOOOOOOOOOPPPPG
GFFFFFFFFFFFFFFFFFFFFFFFYYYYYVVVVVVVVVVVOOOOOOOOOOOOOOOOOOOPPPPG
GFFFFFFFFFFFFFFFFFFFFFFFFYYYYYVVVVVVVVVOOOOOOOOOOOOOOOOOOOOPPPPG
GFFFFFFFFFFFFFFFFFFFFFFFFFYYYYYVVVVVVVOOOOOOOOOOOOOOOOOOOOOPPPPG
GFFFFFFFFFFFFFFFFFFFFFFFFFFYYYYYVVVVVOOOOOOOOOOOOOOOOOOOOOOPPPPG
GFFFFFFFFFFFFFFFFFFFFFFFFFFFYYYYYYYYPPPPPPPPPPPPPPPPPPPPPPPPPPPG
GFFFFFFFFFFFFFFFFFFFFFFFFFFFFYYYYYYPPPPPPPPPPPPPPPPPPPPPPPPPPPPG
GFFFFFFFFFFFFFFFFFFFFFFFFFFFFFYYYYPPPPPPPPPPPPPPPPPPPPPPPPPPPPPG
GFFFFFFFFFFFFFFFFFFFFFFFFFFFFFFYYPPPPPPPPPPPPPPPPPPPPPPPPPPPPPPG
GBBBBBBBBBBBBBBBBBBBBBBBBBBBBBBBBBBBBBBBBBBBBBBBBBBBBBBBBBBBBBBB
