BBBBBBBBBBBBBBBBBBBBBBBBBBBBBBBBBBBBBBBBBBBBBBBBBBBBBBBBBBBBBBBB
GSRRRRRRRRRRRRRRRRRRRRRRRRRRRRRRRRRRRRRRRRRRRRRRRRRRRRRRRRRRRRYG
GSSRRRRRRRRRRRRRRRRRRRRRRRRRRRRRRRRRRRRRRRRRRRRRRRRRRRRRRRRRRYYG
GSSSRRRRRRRRRRRRRRRRRRRRRRRRRRRRRRRRRRRRRRRRRRRRRRRRRRRRRRRRYYYG
GSSSAKKKKKKKKKKKKKKKKKKKKKKKKKKKKKKKKKKKKKKKKKKKKKKKKKKKKKKVYYYG
GSSSAAKKKKKKKKKKKKKKKKKKKKKKKKKKKKKKKKKKKKKKKKKKKKKKKKKKKKVVYYYG
GSSSAAAKKKKKKKKKKKKKKKKKKKKKKKKKKKKKKKKKKKKKKKKKKKKKKKKKKVVVYYYG
GSSSAAAAKKKKKKKKKKKKKKKKKKKKKKKKKKKKKKKKKKKKKKKKKKKKKKKKVVVVYYYG
GSSSAAAAAKKKKKKKKKKKKKKKKKKKKKKKKKKKKKKKKKKKKKKKKKKKKKKVVVVVYYYG
GSSSAAAAAAKKKKKKKKKKKKKKKKKKKKKKKKKKKKKKKKKKKKKKKKKKKKVVVVVVYYYG
GSSSAAAAAAAKKKKKKKKKKKKKKKKKKKKKKKKKKKKKKKKKKKKKKKKKKVVVVVVVYYYG
GSSSAAAAAAAAKKKKKKKKKKKKKKKKKKKKKKKKKKKKKKKKKKKKKKKKVVVVVVVVYYYG
GSSSAAAAAAAAAKKKKKKKKKKKKKKKKKKKKKKKKKKKKKKKKKKKKKKVVVVVVVVVYYYG
GSSSAAAAAAAAAAKKKKKKKKKKKKKKKKKKKKKKKKKKKKKKKKKKKKVVVVVVVVVVYYYG
GSSSAAAAAAAAAAAKKKKKKKKKKKKKKKKKKKKKKKKKKKKKKKKKKVVVVVVVVVVVYYYG
GSSSAAAAAAAAAAAAKKKKKKKKKKKKKKKKKKKKKKKKKKKKKKKKVVVVVVVVVVVVYYYG
GSSSAAAAAAAAAAAAAKKKKKKKKKKKKKKKKKKKKKKKKKKKKKKVVVVVVVVVVVVVYYYG
GSSSAAAAAAAAAAAAAAKKKKKKKKKKKKKKKKKKKKKKKKKKKKVVVVVVVVVVVVVVYYYG
GSSSAAAAAAAAAAAAAAAKKKKKKKKKKKKKKKKKKKKKKKKKKVVVVVVVVVVVVVVVYYYG
GSSSAAAAAAAAAAAAAAAAKKKKKKKKKKKKKKKKKKKKKKKKVVVVVVVVVVVVVVVVYYYG
GSSSAAAAAAAAAAAAAAAAAKKKKKKKKKKKKKKKKKKKKKKVVVVVVVVVVVVVVVVVYYYG
GSSSAAAAAAAAAAAAAAAAAAKKKKKKKKKKKKKKKKKKKKVVVVVVVVVVVVVVVVVVYYYG
GSSSAAAAAAAAAAAAAAAAAAAKKKKKKKKKKKKKKKKKKVVVVVVVVVVVVVVVVVVVYYYG
GSSSAAAAAAAAAAAAAAAAAAAAKKKKKKKKKKKKKKKKVVVVVVVVVVVVVVVVVVVVYYYG
GSSSAAAAAAAAAAAAAAAAAAAAAKKKKKKKKKKKKKKVVVVVVVVVVVVVVVVVVVVVYYYG
GSSSAAAAAAAAAAAAAAAAAAAAAAKKKKKKKKKKKKVVVVVVVVVVVVVVVVVVVVVVYYYG
GSSSAAAAAAAAAAAAAAAAAAAAAAAKKKKKKKKKKVVVVVVVVVVVVVVVVVVVVVVVYYYG
GSSSAAAAAAAAAAAAAAAAAAAAAAAAKKKKKKKKVVVVVVVVVVVVVVVVVVVVVVVVYYYG
GSSSAAAAAAAAAAAAAAAAAAAAAAAAAKKKKKKVVVVVVVVVVVVVVVVVVVVVVVVVYYYG
GSSSAAAAAAAAAAAAAAAAAAAAAAAAAAKKKKVVVVVVVVVVVVVVVVVVVVVVVVVVYYYG
GSSSAAAAAAAAAAAAAAAAAAAAAAAAAAAKKVVVVVVVVVVVVVVVVVVVVVVVVVVVYYYG
GSSSAAAAAAAAAAAAAAAAAAAAAAAAAAAAVVVVVVVVVVVVVVVVVVVVVVVVVVVVYYYG
GSSSAAAAAAAAAAAAAAAAAAAAAAAAAAAAVVVVVVVVVVVVVVVVVVVVVVVVVVVVYYYG
GSSSAAAAAAAAAAAAAAAAAAAAAAAAAAAOOVVVVVVVVVVVVVVVVVVVVVVVVVVVYYYG
GSSSAAAAAAAAAAAAAAAAAAAAAAAAAAOOOOVVVVVVVVVVVVVVVVVVVVVVVVVVYYYG
GSSSAAAAAAAAAAAAAAAAAAAAAAAAAOOOOOOVVVVVVVVVVVVVVVVVVVVVVVVVYYYG
GSSSAAAAAAAAAAAAAAAAAAAAAAAAOOOOOOOOVVVVVVVVVVVVVVVVVVVVVVVVYYYG
GSSSAAAAAAAAAAAAAAAAAAAAAAAOOOOOOOOOOVVVVVVVVVVVVVVVVVVVVVVVYYYG
GSSSAAAAAAAAAAAAAAAAAAAAAAOOOOOOOOOOOOVVVVVVVVVVVVVVVVVVVVVVYYYG
GSSSAAAAAAAAAAAAAAAAAAAAAOOOOOOOOOOOOOOVVVVVVVVVVVVVVVVVVVVVYYYG
GSSSAAAAAAAAAAAAAAAAAAAAOOOOOOOOOOOOOOOOVVVVVVVVVVVVVVVVVVVVYYYG
GSSSAAAAAAAAAAAAAAAAAAAOOOOOOOOOOOOOOOOOOVVVVVVVVVVVVVVVVVVVYYYG
GSSSAAAAAAAAAAAAAAAAAAOOOOOOOOOOOOOOOOOOOOVVVVVVVVVVVVVVVVVVYYYG
GSSSAAAAAAAAAAAAAAAAAOOOOOOOOOOOOOOOOOOOOOOVVVVVVVVVVVVVVVVVYYYG
GSSSAAAAAAAAAAAAAAAAOOOOOOOOOOOOOOOOOOOOOOOOVVVVVVVVVVVVVVVVYYYG
GSSSAAAAAAAAAAAAAAAOOOOOOOOOOOOOOOOOOOOOOOOOOVVVVVVVVVVVVVVVYYYG
GSSSAAAAAAAAAAAAAAOOOOOOOOOOOOOOOOOOOOOOOOOOOOVVVVVVVVVVVVVVYYYG
GSSSAAAAAAAAAAAAAOOOOOOOOOOOOOOOOOOOOOOOOOOOOOOVVVVVVVVVVVVVYYYG
GSSSAAAAAAAAAAAAOOOOOOOOOOOOOOOOOOOOOOOOOOOOOOOOVVVVVVVVVVVVYYYG
GSSSAAAAAAAAAAAOOOOOOOOOOOOOOOOOOOOOOOOOOOOOOOOOOVVVVVVVVVVVYYYG
GSSSAAAAAAAAAAOOOOOOOOOOOOOOOOOOOOOOOOOOOOOOOOOOOOVVVVVVVVVVYYYG
GSSSAAAAAAAAAOOOOOOOOOOOOOOOOOOOOOOOOOOOOOOOOOOOOOOVVVVVVVVVYYYG
GSSSAAAAAAAAOOOOOOOOOOOOOOOOOOOOOOOOOOOOOOOOOOOOOOOOVVVVVVVVYYYG
GSSSAAAAAAAOOOOOOOOOOOOOOOOOOOOOOOOOOOOOOOOOOOOOOOOOOVVVVVVVYYYG
GSSSAAAAAAOOOOOOOOOOOOOOOOOOOOOOOOOOOOOOOOOOOOOOOOOOOOVVVVVVYYYG
GSSSAAAAAOOOOOOOOOOOOOOOOOOOOOOOOOOOOOOOOOOOOOOOOOOOOOOVVVVVYYYG
GSSSAAAAOOOOOOOOOOOOOOOOOOOOOOOOOOOOOOOOOOOOOOOOOOOOOOOOVVVVYYYG
GSSSAAAOOOOOOOOOOOOOOOOOOOOOOOOOOOOOOOOOOOOOOOOOOOOOOOOOOVVVYYYG
GSSSAAOOOOOOOOOOOOOOOOOOOOOOOOOOOOOOOOOOOOOOOOOOOOOOOOOOOOVVYYYG
GSSSAOOOOOOOOOOOOOOOOOOOOOOOOOOOOOOOOOOOOOOOOOOOOOOOOOOOOOOVYYYG
GSSPPPPPPPPPPPPPPPPPPPPPPPPPPPPPPPPPPPPPPPPPPPPPPPPPPPPPPPPPPYYG
GSPPPPPPPPPPPPPPPPPPPPPPPPPPPPPPPPPPPPPPPPPPPPPPPPPPPPPPPPPPPPYG
GPPPPPPPPPPPPPPPPPPPPPPPPPPPPPPPPPPPPPPPPPPPPPPPPPPPPPPPPPPPPPPG
GBBBBBBBBBBBBBBBBBBBBBBBBBBBBBBBBBBBBBBBBBBBBBBBBBBBBBBBBBBBBBBB
