BBBBBBBBBBBBBBBBBBBBBBBBBBBBBBBBBBBBBBBBBBBBBBBBBBBBBBBBBBBBBBBB
GPPPPPPPPPPPPPPPPPPPPPPPPPPPPPPPPPPPPPPPPPPPPPPPPPPPPPPPPPPPPPAG
GPPPPPPPPPPPPPPPPPPPPPPPPPPPPPPPPPPPPPPPPPPPPPPPPPPPPPPPPPPPPAAG
GPPPPPPPPPPPPPPPPPPPPPPPPPPPPPPPPPPPPPPPPPPPPPPPPPPPPPPPPPPPAAAG
GPPPSSSSSSSSSSSSSSSSSSSSSSSSSSSSSSSSSSSSSSSSSSSSSSSSSSSSSSSAAAAG
GPPPSSSSSSSSSSSSSSSSSSSSSSSSSSSSSSSSSSSSSSSSSSSSSSSSSSSSSSYAAAAG
GPPPSSSSSSSSSSSSSSSSSSSSSSSSSSSSSSSSSSSSSSSSSSSSSSSSSSSSSYYAAAAG
GPPPSSSSSSSSSSSSSSSSSSSSSSSSSSSSSSSSSSSSSSSSSSSSSSSSSSSSYYYAAAAG
GPPPSSSSSSSSSSSSSSSSSSSSSSSSSSSSSSSSSSSSSSSSSSSSSSSSSSSYYYYAAAAG
GPPPSSSSSSSSSSSSSSSSSSSSSSSSSSSSSSSSSSSSSSSSSSSSSSSSSSYYYYYAAAAG
GPPPSSSSSSSSSSSSSSSSSSSSSSSSSSSSSSSSSSSSSSSSSSSSSSSSSYYYYYYAAAAG
GPPPSSSSSSSSSSSSSSSSSSSSSSSSSSSSSSSSSSSSSSSSSSSSSSSSYYYYYYYAAAAG
GPPPSSSSSSSSSSSSSSSSSSSSSSSSSSSSSSSSSSSSSSSSSSSSSSSYYYYYYYYAAAAG
GPPPSSSSSSSSSSSSSSSSSSSSSSSSSSSSSSSSSSSSSSSSSSSSSSYYYYYYYYYAAAAG
GPPPSSSSSSSSSSSSSSSSSSSSSSSSSSSSSSSSSSSSSSSSSSSSSYYYYYYYYYYAAAAG
GPPPSSSSSSSSSSSSSSSSSSSSSSSSSSSSSSSSSSSSSSSSSSSSYYYYYYYYYYYAAAAG
GPPPSSSSSSSSSSSSSSSSSSSSSSSSSSSSSSSSSSSSSSSSSSSYYYYYYYYYYYYAAAAG
GPPPSSSSSSSSSSSSSSSSSSSSSSSSSSSSSSSSSSSSSSSSSSYYYYYYYYYYYYYAAAAG
GPPPSSSSSSSSSSSSSSSSSSSSSSSSSSSSSSSSSSSSSSSSSYYYYYYYYYYYYYYAAAAG
GPPPSSSSSSSSSSSSSSSSSSSSSSSSSSSSSSSSSSSSSSSSYYYYYYYYYYYYYYYAAAAG
GPPPSSSSSSSSSSSSSSSSSSSSSSSSSSSSSSSSSSSSSSSYYYYYYYYYYYYYYYYAAAAG
GPPPSSSSSSSSSSSSSSSSSSSSSSSSSSSSSSSSSSSSSSYYYYYYYYYYYYYYYYYAAAAG
GPPPSSSSSSSSSSSSSSSSSSSSSSSSSSSSSSSSSSSSSYYYYYYYYYYYYYYYYYYAAAAG
GPPPSSSSSSSSSSSSSSSSSSSSSSSSSSSSSSSSSSSSYYYYYYYYYYYYYYYYYYYAAAAG
GPPPSSSSSSSSSSSSSSSSSSSSSSSSSSSSSSSSSSSYYYYYYYYYYYYYYYYYYYYAAAAG
GPPPSSSSSSSSSSSSSSSSSSSSSSSSSSSSSSSSSSYYYYYYYYYYYYYYYYYYYYYAAAAG
GPPPSSSSSSSSSSSSSSSSSSSSSSSSSSSSSSSSSYYYYYYYYYYYYYYYYYYYYYYAAAAG
GPPPSSSSSSSSSSSSSSSSSSSSSSSSSSSSSSSSYYYYYYYYYYYYYYYYYYYYYYYAAAAG
GPPPSSSSSSSSSSSSSSSSSSSSSSSSSSSSSSSYYYYYYYYYYYYYYYYYYYYYYYYAAAAG
GPPPSSSSSSSSSSSSSSSSSSSSSSSSSSSSSSYYYYYYYYYYYYYYYYYYYYYYYYYAAAAG
GPPPSSSSSSSSSSSSSSSSSSSSSSSSSSSSSYYYYYYYYYYYYYYYYYYYYYYYYYYAAAAG
GPPPSSSSSSSSSSSSSSSSSSSSSSSSSSSSYYYYYYYYYYYYYYYYYYYYYYYYYYYAAAAG
GPPPSSSSSSSSSSSSSSSSSSSSSSSSSSSYYYYYYYYYYYYYYYYYYYYYYYYYYYYAAAAG
GPPPSSSSSSSSSSSSSSSSSSSSSSSSSSYYYYYYYYYYYYYYYYYYYYYYYYYYYYYAAAAG
GPPPSSSSSSSSSSSSSSSSSSSSSSSSSYYYYYYYYYYYYYYYYYYYYYYYYYYYYYYAAAAG
GPPPSSSSSSSSSSSSSSSSSSSSSSSSYYYYYYYYYYYYYYYYYYYYYYYYYYYYYYYAAAAG
GPPPSSSSSSSSSSSSSSSSSSSSSSSYYYYYYYYYYYYYYYYYYYYYYYYYYYYYYYYAAAAG
GPPPSSSSSSSSSSSSSSSSSSSSSSYYYYYYYYYYYYYYYYYYYYYYYYYYYYYYYYYAAAAG
GPPPSSSSSSSSSSSSSSSSSSSSSYYYYYYYYYYYYYYYYYYYYYYYYYYYYYYYYYYAAAAG
GPPPSSSSSSSSSSSSSSSSSSSSYYYYYYYYYYYYYYYYYYYYYYYYYYYYYYYYYYYAAAAG
GPPPSSSSSSSSSSSSSSSSSSSYYYYYYYYYYYYYYYYYYYYYYYYYYYYYYYYYYYYAAAAG
GPPPSSSSSSSSSSSSSSSSSSYYYYYYYYYYYYYYYYYYYYYYYYYYYYYYYYYYYYYAAAAG
GPPPSSSSSSSSSSSSSSSSSYYYYYYYYYYYYYYYYYYYYYYYYYYYYYYYYYYYYYYAAAAG
GPPPSSSSSSSSSSSSSSSSYYYYYYYYYYYYYYYYYYYYYYYYYYYYYYYYYYYYYYYAAAAG
GPPPSSSSSSSSSSSSSSSYYYYYYYYYYYYYYYYYYYYYYYYYYYYYYYYYYYYYYYYAAAAG
GPPPSSSSSSSSSSSSSSYYYYYYYYYYYYYYYYYYYYYYYYYYYYYYYYYYYYYYYYYAAAAG
GPPPSSSSSSSSSSSSSYYYYYYYYYYYYYYYYYYYYYYYYYYYYYYYYYYYYYYYYYYAAAAG
GPPPSSSSSSSSSSSSYYYYYYYYYYYYYYYYYYYYYYYYYYYYYYYYYYYYYYYYYYYAAAAG
GPPPSSSSSSSSSSSYYYYYYYYYYYYYYYYYYYYYYYYYYYYYYYYYYYYYYYYYYYYAAAAG
GPPPSSSSSSSSSSYYYYYYYYYYYYYYYYYYYYYYYYYYYYYYYYYYYYYYYYYYYYYAAAAG
GPPPSSSSSSSSSYYYYYYYYYYYYYYYYYYYYYYYYYYYYYYYYYYYYYYYYYYYYYYAAAAG
GPPPSSSSSSSSYYYYYYYYYYYYYYYYYYYYYYYYYYYYYYYYYYYYYYYYYYYYYYYAAAAG
GPPPSSSSSSSYYYYYYYYYYYYYYYYYYYYYYYYYYYYYYYYYYYYYYYYYYYYYYYYAAAAG
GPPPSSSSSSYYYYYYYYYYYYYYYYYYYYYYYYYYYYYYYYYYYYYYYYYYYYYYYYYAAAAG
GPPPSSSSSYYYYYYYYYYYYYYYYYYYYYYYYYYYYYYYYYYYYYYYYYYYYYYYYYYAAAAG
GPPPSSSSYYYYYYYYYYYYYYYYYYYYYYYYYYYYYYYYYYYYYYYYYYYYYYYYYYYAAAAG
GPPPSSSYYYYYYYYYYYYYYYYYYYYYYYYYYYYYYYYYYYYYYYYYYYYYYYYYYYYAAAAG
GPPPSSYYYYYYYYYYYYYYYYYYYYYYYYYYYYYYYYYYYYYYYYYYYYYYYYYYYYYAAAAG
GPPPSYYYYYYYYYYYYYYYYYYYYYYYYYYYYYYYYYYYYYYYYYYYYYYYYYYYYYYAAAAG
GPPPAAAAAAAAAAAAAAAAAAAAAAAAAAAAAAAAAAAAAAAAAAAAAAAAAAAAAAAAAAAG
GPPAAAAAAAAAAAAAAAAAAAAAAAAAAAAAAAAAAAAAAAAAAAAAAAAAAAAAAAAAAAAG
GPAAAAAAAAAAAAAAAAAAAAAAAAAAAAAAAAAAAAAAAAAAAAAAAAAAAAAAAAAAAAAG
GAAAAAAAAAAAAAAAAAAAAAAAAAAAAAAAAAAAAAAAAAAAAAAAAAAAAAAAAAAAAAAG
GBBBBBBBBBBBBBBBBBBBBBBBBBBBBBBBBBBBBBBBBBBBBBBBBBBBBBBBBBBBBBBB
