BBBBBBBBBBBBBBBBBBBBBBBBBBBBBBBBBBBBBBBBBBBBBBBBBBBBBBBBBBBBBBBB
GPRRRRRRRRRRRRRRRRRRRRRRRRRRRRRRRRRRRRRRRRRRRRRRRRRRRRRRRRRRRRMG
GPPRRRRRRRRRRRRRRRRRRRRRRRRRRRRRRRRRRRRRRRRRRRRRRRRRRRRRRRRRRMMG
GPPPRRRRRRRRRRRRRRRRRRRRRRRRRRRRRRRRRRRRRRRRRRRRRRRRRRRRRRRRMMMG
GPPPSYYYYYYYYYYYYYYYYYYYYYYYYYYYYYYYYYYYYYYYYYYYYYYYYYYYYYYMMMMG
GPPPSSYYYYYYYYYYYYYYYYYYYYYYYYYYYYYYYYYYYYYYYYYYYYYYYYYYYYAMMMMG
GPPPSSSYYYYYYYYYYYYYYYYYYYYYYYYYYYYYYYYYYYYYYYYYYYYYYYYYYAAMMMMG
GPPPSSSSYYYYYYYYYYYYYYYYYYYYYYYYYYYYYYYYYYYYYYYYYYYYYYYYAAAMMMMG
GPPPSSSSSYYYYYYYYYYYYYYYYYYYYYYYYYYYYYYYYYYYYYYYYYYYYYYAAAAMMMMG
GPPPSSSSSSYYYYYYYYYYYYYYYYYYYYYYYYYYYYYYYYYYYYYYYYYYYYAAAAAMMMMG
GPPPSSSSSSSYYYYYYYYYYYYYYYYYYYYYYYYYYYYYYYYYYYYYYYYYYAAAAAAMMMMG
GPPPSSSSSSSSYYYYYYYYYYYYYYYYYYYYYYYYYYYYYYYYYYYYYYYYAAAAAAAMMMMG
GPPPSSSSSSSSSYYYYYYYYYYYYYYYYYYYYYYYYYYYYYYYYYYYYYYAAAAAAAAMMMMG
GPPPSSSSSSSSSSYYYYYYYYYYYYYYYYYYYYYYYYYYYYYYYYYYYYAAAAAAAAAMMMMG
GPPPSSSSSSSSSSSYYYYYYYYYYYYYYYYYYYYYYYYYYYYYYYYYYAAAAAAAAAAMMMMG
GPPPSSSSSSSSSSSSYYYYYYYYYYYYYYYYYYYYYYYYYYYYYYYYAAAAAAAAAAAMMMMG
GPPPSSSSSSSSSSSSSYYYYYYYYYYYYYYYYYYYYYYYYYYYYYYAAAAAAAAAAAAMMMMG
GPPPSSSSSSSSSSSSSSYYYYYYYYYYYYYYYYYYYYYYYYYYYYAAAAAAAAAAAAAMMMMG
GPPPSSSSSSSSSSSSSSSYYYYYYYYYYYYYYYYYYYYYYYYYYAAAAAAAAAAAAAAMMMMG
GPPPSSSSSSSSSSSSSSSSYYYYYYYYYYYYYYYYYYYYYYYYAAAAAAAAAAAAAAAMMMMG
GPPPSSSSSSSSSSSSSSSSSYYYYYYYYYYYYYYYYYYYYYYAAAAAAAAAAAAAAAAMMMMG
GPPPSSSSSSSSSSSSSSSSSSYYYYYYYYYYYYYYYYYYYYAAAAAAAAAAAAAAAAAMMMMG
GPPPSSSSSSSSSSSSSSSSSSSYYYYYYYYYYYYYYYYYYAAAAAAAAAAAAAAAAAAMMMMG
GPPPSSSSSSSSSSSSSSSSSSSSYYYYYYYYYYYYYYYYAAAAAAAAAAAAAAAAAAAMMMMG
GPPPSSSSSSSSSSSSSSSSSSSSSYYYYYYYYYYYYYYAAAAAAAAAAAAAAAAAAAAMMMMG
GPPPSSSSSSSSSSSSSSSSSSSSSSYYYYYYYYYYYYAAAAAAAAAAAAAAAAAAAAAMMMMG
GPPPSSSSSSSSSSSSSSSSSSSSSSSYYYYYYYYYYAAAAAAAAAAAAAAAAAAAAAAMMMMG
GPPPSSSSSSSSSSSSSSSSSSSSSSSSYYYYYYYYAAAAAAAAAAAAAAAAAAAAAAAMMMMG
GPPPSSSSSSSSSSSSSSSSSSSSSSSSSYYYYYYAAAAAAAAAAAAAAAAAAAAAAAAMMMMG
GPPPSSSSSSSSSSSSSSSSSSSSSSSSSSYYYYAAAAAAAAAAAAAAAAAAAAAAAAAMMMMG
GPPPSSSSSSSSSSSSSSSSSSSSSSSSSSSYYAAAAAAAAAAAAAAAAAAAAAAAAAAMMMMG
GPPPSSSSSSSSSSSSSSSSSSSSSSSSSSSSAAAAAAAAAAAAAAAAAAAAAAAAAAAMMMMG
GPPPSSSSSSSSSSSSSSSSSSSSSSSSSSSVVAAAAAAAAAAAAAAAAAAAAAAAAAAMMMMG
GPPPSSSSSSSSSSSSSSSSSSSSSSSSSSVVVVAAAAAAAAAAAAAAAAAAAAAAAAAMMMMG
GPPPSSSSSSSSSSSSSSSSSSSSSSSSSVVVVVVAAAAAAAAAAAAAAAAAAAAAAAAMMMMG
GPPPSSSSSSSSSSSSSSSSSSSSSSSSVVVVVVVVAAAAAAAAAAAAAAAAAAAAAAAMMMMG
GPPPSSSSSSSSSSSSSSSSSSSSSSSVVVVVVVVVVAAAAAAAAAAAAAAAAAAAAAAMMMMG
GPPPSSSSSSSSSSSSSSSSSSSSSSVVVVVVVVVVVVAAAAAAAAAAAAAAAAAAAAAMMMMG
GPPPSSSSSSSSSSSSSSSSSSSSSVVVVVVVVVVVVVVAAAAAAAAAAAAAAAAAAAAMMMMG
GPPPSSSSSSSSSSSSSSSSSSSSVVVVVVVVVVVVVVVVAAAAAAAAAAAAAAAAAAAMMMMG
GPPPSSSSSSSSSSSSSSSSSSSVVVVVVVVVVVVVVVVVVAAAAAAAAAAAAAAAAAAMMMMG
GPPPSSSSSSSSSSSSSSSSSSVVVVVVVVVVVVVVVVVVVVAAAAAAAAAAAAAAAAAMMMMG
GPPPSSSSSSSSSSSSSSSSSVVVVVVVVVVVVVVVVVVVVVVAAAAAAAAAAAAAAAAMMMMG
GPPPSSSSSSSSSSSSSSSSVVVVVVVVVVVVVVVVVVVVVVVVAAAAAAAAAAAAAAAMMMMG
GPPPSSSSSSSSSSSSSSSVVVVVVVVVVVVVVVVVVVVVVVVVVAAAAAAAAAAAAAAMMMMG
GPPPSSSSSSSSSSSSSSVVVVVVVVVVVVVVVVVVVVVVVVVVVVAAAAAAAAAAAAAMMMMG
GPPPSSSSSSSSSSSSSVVVVVVVVVVVVVVVVVVVVVVVVVVVVVVAAAAAAAAAAAAMMMMG
GPPPSSSSSSSSSSSSVVVVVVVVVVVVVVVVVVVVVVVVVVVVVVVVAAAAAAAAAAAMMMMG
GPPPSSSSSSSSSSSVVVVVVVVVVVVVVVVVVVVVVVVVVVVVVVVVVAAAAAAAAAAMMMMG
GPPPSSSSSSSSSSVVVVVVVVVVVVVVVVVVVVVVVVVVVVVVVVVVVVAAAAAAAAAMMMMG
GPPPSSSSSSSSSVVVVVVVVVVVVVVVVVVVVVVVVVVVVVVVVVVVVVVAAAAAAAAMMMMG
GPPPSSSSSSSSVVVVVVVVVVVVVVVVVVVVVVVVVVVVVVVVVVVVVVVVAAAAAAAMMMMG
GPPPSSSSSSSVVVVVVVVVVVVVVVVVVVVVVVVVVVVVVVVVVVVVVVVVVAAAAAAMMMMG
GPPPSSSSSSVVVVVVVVVVVVVVVVVVVVVVVVVVVVVVVVVVVVVVVVVVVVAAAAAMMMMG
GPPPSSSSSVVVVVVVVVVVVVVVVVVVVVVVVVVVVVVVVVVVVVVVVVVVVVVAAAAMMMMG
GPPPSSSSVVVVVVVVVVVVVVVVVVVVVVVVVVVVVVVVVVVVVVVVVVVVVVVVAAAMMMMG
GPPPSSSVVVVVVVVVVVVVVVVVVVVVVVVVVVVVVVVVVVVVVVVVVVVVVVVVVAAMMMMG
GPPPSSVVVVVVVVVVVVVVVVVVVVVVVVVVVVVVVVVVVVVVVVVVVVVVVVVVVVAMMMMG
GPPPSVVVVVVVVVVVVVVVVVVVVVVVVVVVVVVVVVVVVVVVVVVVVVVVVVVVVVVMMMMG
GPPPOOOOOOOOOOOOOOOOOOOOOOOOOOOOOOOOOOOOOOOOOOOOOOOOOOOOOOOOMMMG
GPPOOOOOOOOOOOOOOOOOOOOOOOOOOOOOOOOOOOOOOOOOOOOOOOOOOOOOOOOOOMMG
GPOOOOOOOOOOOOOOOOOOOOOOOOOOOOOOOOOOOOOOOOOOOOOOOOOOOOOOOOOOOOMG
GOOOOOOOOOOOOOOOOOOOOOOOOOOOOOOOOOOOOOOOOOOOOOOOOOOOOOOOOOOOOOOG
GBBBBBBBBBBBBBBBBBBBBBBBBBBBBBBBBBBBBBBBBBBBBBBBBBBBBBBBBBBBBBBB
