BBBBBBBBBBBBBBBBBBBBBBBBBBBBBBBBBBBBBBBBBBBBBBBBBBBBBBBBBBBBBBBB
GRRRRRRRRRRRRRRRRRRRRRRRRRRRRRRRRRRRRRRRRRRRRRRRRRRRRRRRRRRRRRFG
GRRRRRRRRRRRRRRRRRRRRRRRRRRRRRRRRRRRRRRRRRRRRRRRRRRRRRRRRRRRRAFG
GRRRRRRRRRRRRRRRRRRRRRRRRRRRRRRRRRRRRRRRRRRRRRRRRRRRRRRRRRRRAFFG
GYYYYYYYYYYYYYYYYYYYYYYYYYYYYYYYYYYYYYYYYYYYYYYYYYYYYYYYRRRAAFFG
GYYYYYYYYYYYYYYYYYYYYYYYYYYYYYYYYYYYYYYYYYYYYYYYYYYYYYYRRRAAFFFG
GYYYYYYYYYYYYYYYYYYYYYYYYYYYYYYYYYYYYYYYYYYYYYYYYYYYYYYRRAAAFFFG
GYYYYYYYYYYYYYYYYYYYYYYYYYYYYYYYYYYYYYYYYYYYYYYYYYYYYYRRAAAFFFFG
GYYYYYYYYYYYYYYYYYYYYYYYYYYYYYYYYYYYYYYYYYYYYYYYYYYYYYRAAAAFFFFG
GYYYYYYYYYYYYYYYYYYYYYYYYYYYYYYYYYYYYYYYYYYYYYYYYYYYYRAAAAFFFFFG
GYYYYYYYYYYYYYYYYYYYYYYYYYYYYYYYYYYYYYYYYYYYYYYYYYYYYAAAAAFFFFFG
GYYYYYYYYYYYYYYYYYYYYYYYYYYYYYYYYYYYYYYYYYYYYYYYYYYYAAAAAFFFFFFG
GYYYYYYYYYYYYYYYYYYYYYYYYYYYYYYYYYYYYYYYYYYYYYYYYYYSAAAAAFFFFFFG
GYYYYYYYYYYYYYYYYYYYYYYYYYYYYYYYYYYYYYYYYYYYYYYYYYSAAAAAFFFFFFFG
GYYYYYYYYYYYYYYYYYYYYYYYYYYYYYYYYYYYYYYYYYYYYYYYYSSAAAAAFFFFFFFG
GYYYYYYYYYYYYYYYYYYYYYYYYYYYYYYYYYYYYYYYYYYYYYYYSSAAAAAFFFFFFFFG
GYYYYYYYYYYYYYYYYYYYYYYYYYYYYYYYYYYYYYYYYYYYYYYSSSAAAAAFFFFFFFFG
GYYYYYYYYYYYYYYYYYYYYYYYYYYYYYYYYYYYYYYYYYYYYYSSSAAAAAFFFFFFFFFG
GYYYYYYYYYYYYYYYYYYYYYYYYYYYYYYYYYYYYYYYYYYYYSSSSAAAAAFFFFFFFFFG
GYYYYYYYYYYYYYYYYYYYYYYYYYYYYYYYYYYYYYYYYYYYSSSSAAAAAFFFFFFFFFFG
GYYYYYYYYYYYYYYYYYYYYYYYYYYYYYYYYYYYYYYYYYYSSSSSAAAAAFFFFFFFFFFG
GYYYYYYYYYYYYYYYYYYYYYYYYYYYYYYYYYYYYYYYYYSSSSSAAAAAFFFFFFFFFFFG
GYYYYYYYYYYYYYYYYYYYYYYYYYYYYYYYYYYYYYYYYSSSSSSAAAAAFFFFFFFFFFFG
GYYYYYYYYYYYYYYYYYYYYYYYYYYYYYYYYYYYYYYYSSSSSSAAAAAFFFFFFFFFFFFG
GYYYYYYYYYYYYYYYYYYYYYYYYYYYYYYYYYYYYYYSSSSSSSAAAAAFFFFFFFFFFFFG
GYYYYYYYYYYYYYYYYYYYYYYYYYYYYYYYYYYYYYSSSSSSSAAAAAFFFFFFFFFFFFFG
GYYYYYYYYYYYYYYYYYYYYYYYYYYYYYYYYYYYYSSSSSSSSAAAAAFFFFFFFFFFFFFG
GYYYYYYYYYYYYYYYYYYYYYYYYYYYYYYYYYYYSSSSSSSSAAAAAFFFFFFFFFFFFFFG
GYYYYYYYYYYYYYYYYYYYYYYYYYYYYYYYYYYSSSSSSSSSAAAAAFFFFFFFFFFFFFFG
GYYYYYYYYYYYYYYYYYYYYYYYYYYYYYYYYYSSSSSSSSSAAAAAFFFFFFFFFFFFFFFG
GYYYYYYYYYYYYYYYYYYYYYYYYYYYYYYYYSSSSSSSSSSAAAAAFFFFFFFFFFFFFFFG
GYYYYYYYYYYYYYYYYYYYYYYYYYYYYYYYSSSSSSSSSSAAAAAFFFFFFFFFFFFFFFFG
GYYYYYYYYYYYYYYYYYYYYYYYYYYYYYYSSSSSSSSSSSAAAAAFFFFFFFFFFFFFFFFG
GYYYYYYYYYYYYYYYYYYYYYYYYYYYYYSSSSSSSSSSSAAAAAFFFFFFFFFFFFFFFFFG
GYYYYYYYYYYYYYYYYYYYYYYYYYYYYSSSSSSSSSSSSAAAAAFFFFFFFFFFFFFFFFFG
GYYYYYYYYYYYYYYYYYYYYYYYYYYYSSSSSSSSSSSSAAAAAFFFFFFFFFFFFFFFFFFG
GYYYYYYYYYYYYYYYYYYYYYYYYYYSSSSSSSSSSSSSAAAAAFFFFFFFFFFFFFFFFFFG
GYYYYYYYYYYYYYYYYYYYYYYYYYSSSSSSSSSSSSSAAAAAFFFFFFFFFFFFFFFFFFFG
GYYYYYYYYYYYYYYYYYYYYYYYYSSSSSSSSSSSSSSAAAAAFFFFFFFFFFFFFFFFFFFG
GYYYYYYYYYYYYYYYYYYYYYYYSSSSSSSSSSSSSSAAAAAFFFFFFFFFFFFFFFFFFFFG
GYYYYYYYYYYYYYYYYYYYYYYSSSSSSSSSSSSSSSAAAAAFFFFFFFFFFFFFFFFFFFFG
GYYYYYYYYYYYYYYYYYYYYYSSSSSSSSSSSSSSSAAAAAFFFFFFFFFFFFFFFFFFFFFG
GYYYYYYYYYYYYYYYYYYYYSSSSSSSSSSSSSSSSAAAAAFFFFFFFFFFFFFFFFFFFFFG
GYYYYYYYYYYYYYYYYYYYSSSSSSSSSSSSSSSSAAAAAFFFFFFFFFFFFFFFFFFFFFFG
GYYYYYYYYYYYYYYYYYYSSSSSSSSSSSSSSSSSAAAAAFFFFFFFFFFFFFFFFFFFFFFG
GYYYYYYYYYYYYYYYYYSSSSSSSSSSSSSSSSSAAAAAFFFFFFFFFFFFFFFFFFFFFFFG
GYYYYYYYYYYYYYYYYSSSSSSSSSSSSSSSSSSAAAAAFFFFFFFFFFFFFFFFFFFFFFFG
GYYYYYYYYYYYYYYYSSSSSSSSSSSSSSSSSSAAAAAFFFFFFFFFFFFFFFFFFFFFFFFG
GYYYYYYYYYYYYYYSSSSSSSSSSSSSSSSSSSAAAAAFFFFFFFFFFFFFFFFFFFFFFFFG
GYYYYYYYYYYYYYSSSSSSSSSSSSSSSSSSSAAAAAFFFFFFFFFFFFFFFFFFFFFFFFFG
GYYYYYYYYYYYYSSSSSSSSSSSSSSSSSSSSAAAAAFFFFFFFFFFFFFFFFFFFFFFFFFG
GYYYYYYYYYYYSSSSSSSSSSSSSSSSSSSSAAAAAFFFFFFFFFFFFFFFFFFFFFFFFFFG
GYYYYYYYYYYSSSSSSSSSSSSSSSSSSSSSAAAAAFFFFFFFFFFFFFFFFFFFFFFFFFFG
GYYYYYYYYYSSSSSSSSSSSSSSSSSSSSSAAAAAFFFFFFFFFFFFFFFFFFFFFFFFFFFG
GYYYYYYYYSSSSSSSSSSSSSSSSSSSSSSAAAAAFFFFFFFFFFFFFFFFFFFFFFFFFFFG
GYYYYYYYSSSSSSSSSSSSSSSSSSSSSSAAAAAFFFFFFFFFFFFFFFFFFFFFFFFFFFFG
GYYYYYYSSSSSSSSSSSSSSSSSSSSSSSAAAAAFFFFFFFFFFFFFFFFFFFFFFFFFFFFG
GYYYYYSSSSSSSSSSSSSSSSSSSSSSSAAAAAFFFFFFFFFFFFFFFFFFFFFFFFFFFFFG
GYYYYSSSSSSSSSSSSSSSSSSSSSSSSAAAAAFFFFFFFFFFFFFFFFFFFFFFFFFFFFFG
GRRRAAAAAAAAAAAAAAAAAAAAAAAAAAAAAFFFFFFFFFFFFFFFFFFFFFFFFFFFFFFG
GRRAAAAAAAAAAAAAAAAAAAAAAAAAAAAAAFFFFFFFFFFFFFFFFFFFFFFFFFFFFFFG
GRAAAAAAAAAAAAAAAAAAAAAAAAAAAAAAFFFFFFFFFFFFFFFFFFFFFFFFFFFFFFFG
GAAAAAAAAAAAAAAAAAAAAAAAAAAAAAAAFFFFFFFFFFFFFFFFFFFFFFFFFFFFFFFG
GBBBBBBBBBBBBBBBBBBBBBBBBBBBBBBBBBBBBBBBBBBBBBBBBBBBBBBBBBBBBBBB
