BBBBBBBBBBBBBBBBBBBBBBBBBBBBBBBBBBBBBBBBBBBBBBBBBBBBBBBBBBBBBBBB
GFFFFFFFFFFFFFFFFFFFFFFFFFFFFFFFFFFFFFFFFFFFFFFFFFFFFFFFFFFFFFFG
GFFFFFFFFFFFFFFFFFFFFFFFFFFFFFFFFFFFFFFFFFFFFFFFFFFFFFFFFFFFFFFG
GFFFFFFFFFFFFFFFFFFFFFFFFFFFFFFFFFFFFFFFFFFFFFFFFFFFFFFFFFFFFFFG
GFFFFFFFFFFFFFFFFFFFFFFFFFFFFFFFFFFFFFFFFFFFFFFFFFFFFFFFFFFFFFFG
GFFFFFFFFFFFFFFFFFFFFFFFFFFFFFFFFFFFFFFFFFFFFFFFFFFFFFFFFFFFFFFG
GFFFFFFFFFFFFFFFFFFFFFFFFFFFFFFFFFFFFFFFFFFFFFFFFFFFFFFFFFFFFFFG
GFFFFFFFFFFFFFFFFFFFFFFFFFFFFFFFFFFFFFFFFFFFFFFFFFFFFFFFFFFFFFFG
GFFFFFFFFFFFFFFFFFFFFFFFFFFFFFFFFFFFFFFFFFFFFFFFFFFFFFFFFFFFFFFG
GFFFFFFFFFFFFFFFFFFFFFFFFFFFFFFFFFFFFFFFFFFFFFFFFFFFFFFFFFFFFFFG
GFFFFFFFFFFFFFFFFFFFFFFFFFFFFFFFFFFFFFFFFFFFFFFFFFFFFFFFFFFFFFFG
GFFFFFFFFFFFFFFFFFFFFFFFFFFFFFFFFFFFFFFFFFFFFFFFFFFFFFFFFFFFFFFG
GFFFFFFFFFFFFFFFFFFFFFFFFFFFFFFFFFFFFFFFFFFFFFFFFFFFFFFFFFFFFFFG
GFFFFFFFFFFFFFFFFFFFFFFFFFFFFFFFFFFFFFFFFFFFFFFFFFFFFFFFFFFFFFFG
GFFFFFFFFFFFFFFFFFFFFFFFFFFFFFFFFFFFFFFFFFFFFFFFFFFFFFFFFFFFFFFG
GFFFFFFFFFFFFFFFFFFFFFFFFFFFFFFFFFFFFFFFFFFFFFFFFFFFFFFFFFFFFFFG
GFFFFFFFFFFFFFFFFFFFFFFFFFFFFFFFFFFFFFFFFFFFFFFFFFFFFFFFFFFFFFFG
GFFFFFFFFFFFFFFFFSRRRRRRRRRRRRRRRRRRRRRRRRRRRRYFFFFFFFFFFFFFFFFG
GFFFFFFFFFFFFFFFFSSRRRRRRRRRRRRRRRRRRRRRRRRRRYYFFFFFFFFFFFFFFFFG
GFFFFFFFFFFFFFFFFSSSRRRRRRRRRRRRRRRRRRRRRRRRYYYFFFFFFFFFFFFFFFFG
GFFFFFFFFFFFFFFFFSSSAKKKKKKKKKKKKKKKKKKKKKKYYYYFFFFFFFFFFFFFFFFG
GFFFFFFFFFFFFFFFFSSSAAKKKKKKKKKKKKKKKKKKKKVYYYYFFFFFFFFFFFFFFFFG
GFFFFFFFFFFFFFFFFSSSAAAKKKKKKKKKKKKKKKKKKVVYYYYFFFFFFFFFFFFFFFFG
GFFFFFFFFFFFFFFFFSSSAAAAKKKKKKKKKKKKKKKKVVVYYYYFFFFFFFFFFFFFFFFG
GFFFFFFFFFFFFFFFFSSSAAAAAKKKKKKKKKKKKKKVVVVYYYYFFFFFFFFFFFFFFFFG
GFFFFFFFFFFFFFFFFSSSAAAAAAKKKKKKKKKKKKVVVVVYYYYFFFFFFFFFFFFFFFFG
GFFFFFFFFFFFFFFFFSSSAAAAAAAKKKKKKKKKKVVVVVVYYYYFFFFFFFFFFFFFFFFG
GFFFFFFFFFFFFFFFFSSSAAAAAAAAKKKKKKKKVVVVVVVYYYYFFFFFFFFFFFFFFFFG
GFFFFFFFFFFFFFFFFSSSAAAAAAAAAKKKKKKVVVVVVVVYYYYFFFFFFFFFFFFFFFFG
GFFFFFFFFFFFFFFFFSSSAAAAAAAAAAKKKKVVVVVVVVVYYYYFFFFFFFFFFFFFFFFG
GFFFFFFFFFFFFFFFFSSSAAAAAAAAAAAKKVVVVVVVVVVYYYYFFFFFFFFFFFFFFFFG
GFFFFFFFFFFFFFFFFSSSAAAAAAAAAAAAVVVVVVVVVVVYYYYFFFFFFFFFFFFFFFFG
GFFFFFFFFFFFFFFFFSSSAAAAAAAAAAAOOVVVVVVVVVVYYYYFFFFFFFFFFFFFFFFG
GFFFFFFFFFFFFFFFFSSSAAAAAAAAAAOOOOVVVVVVVVVYYYYFFFFFFFFFFFFFFFFG
GFFFFFFFFFFFFFFFFSSSAAAAAAAAAOOOOOOVVVVVVVVYYYYFFFFFFFFFFFFFFFFG
GFFFFFFFFFFFFFFFFSSSAAAAAAAAOOOOOOOOVVVVVVVYYYYFFFFFFFFFFFFFFFFG
GFFFFFFFFFFFFFFFFSSSAAAAAAAOOOOOOOOOOVVVVVVYYYYFFFFFFFFFFFFFFFFG
GFFFFFFFFFFFFFFFFSSSAAAAAAOOOOOOOOOOOOVVVVVYYYYFFFFFFFFFFFFFFFFG
GFFFFFFFFFFFFFFFFSSSAAAAAOOOOOOOOOOOOOOVVVVYYYYFFFFFFFFFFFFFFFFG
GFFFFFFFFFFFFFFFFSSSAAAAOOOOOOOOOOOOOOOOVVVYYYYFFFFFFFFFFFFFFFFG
GFFFFFFFFFFFFFFFFSSSAAAOOOOOOOOOOOOOOOOOOVVYYYYFFFFFFFFFFFFFFFFG
GFFFFFFFFFFFFFFFFSSSAAOOOOOOOOOOOOOOOOOOOOVYYYYFFFFFFFFFFFFFFFFG
GFFFFFFFFFFFFFFFFSSSAOOOOOOOOOOOOOOOOOOOOOOYYYYFFFFFFFFFFFFFFFFG
GFFFFFFFFFFFFFFFFSSSPPPPPPPPPPPPPPPPPPPPPPPPYYYFFFFFFFFFFFFFFFFG
GFFFFFFFFFFFFFFFFSSPPPPPPPPPPPPPPPPPPPPPPPPPPYYFFFFFFFFFFFFFFFFG
GFFFFFFFFFFFFFFFFSPPPPPPPPPPPPPPPPPPPPPPPPPPPPYFFFFFFFFFFFFFFFFG
GFFFFFFFFFFFFFFFFPPPPPPPPPPPPPPPPPPPPPPPPPPPPPPFFFFFFFFFFFFFFFFG
GFFFFFFFFFFFFFFFFFFFFFFFFFFFFFFFFFFFFFFFFFFFFFFFFFFFFFFFFFFFFFFG
GFFFFFFFFFFFFFFFFFFFFFFFFFFFFFFFFFFFFFFFFFFFFFFFFFFFFFFFFFFFFFFG
GFFFFFFFFFFFFFFFFFFFFFFFFFFFFFFFFFFFFFFFFFFFFFFFFFFFFFFFFFFFFFFG
GFFFFFFFFFFFFFFFFFFFFFFFFFFFFFFFFFFFFFFFFFFFFFFFFFFFFFFFFFFFFFFG
GFFFFFFFFFFFFFFFFFFFFFFFFFFFFFFFFFFFFFFFFFFFFFFFFFFFFFFFFFFFFFFG
GFFFFFFFFFFFFFFFFFFFFFFFFFFFFFFFFFFFFFFFFFFFFFFFFFFFFFFFFFFFFFFG
GFFFFFFFFFFFFFFFFFFFFFFFFFFFFFFFFFFFFFFFFFFFFFFFFFFFFFFFFFFFFFFG
GFFFFFFFFFFFFFFFFFFFFFFFFFFFFFFFFFFFFFFFFFFFFFFFFFFFFFFFFFFFFFFG
GFFFFFFFFFFFFFFFFFFFFFFFFFFFFFFFFFFFFFFFFFFFFFFFFFFFFFFFFFFFFFFG
GFFFFFFFFFFFFFFFFFFFFFFFFFFFFFFFFFFFFFFFFFFFFFFFFFFFFFFFFFFFFFFG
GFFFFFFFFFFFFFFFFFFFFFFFFFFFFFFFFFFFFFFFFFFFFFFFFFFFFFFFFFFFFFFG
GFFFFFFFFFFFFFFFFFFFFFFFFFFFFFFFFFFFFFFFFFFFFFFFFFFFFFFFFFFFFFFG
GFFFFFFFFFFFFFFFFFFFFFFFFFFFFFFFFFFFFFFFFFFFFFFFFFFFFFFFFFFFFFFG
GFFFFFFFFFFFFFFFFFFFFFFFFFFFFFFFFFFFFFFFFFFFFFFFFFFFFFFFFFFFFFFG
GFFFFFFFFFFFFFFFFFFFFFFFFFFFFFFFFFFFFFFFFFFFFFFFFFFFFFFFFFFFFFFG
GFFFFFFFFFFFFFFFFFFFFFFFFFFFFFFFFFFFFFFFFFFFFFFFFFFFFFFFFFFFFFFG
GBBBBBBBBBBBBBBBBBBBBBBBBBBBBBBBBBBBBBBBBBBBBBBBBBBBBBBBBBBBBBBB
