BBBBBBBBBBBBBBBBBBBBBBBBBBBBBBBBBBBBBBBBBBBBBBBBBBBBBBBBBBBBBBBB
GFFFFFFFFFFFFFFFFFFFFFFFFFFFFFFBBFFFFFFFFFFFFFFFFFFFFFFFFFFFFFFG
GFFFFFFFFFFFFFFFFFFFFFFFFFFFFFBFFBFFFFFFFFFFFFFFFFFFFFFFFFFFFFFG
GFFFFFFFFFFFFFFFFFFFFFFFFFFFFBFFFFBFFFFFFFFFFFFFFFFFFFFFFFFFFFFG
GFFFFFFFFFFFFFFFFFFFFFFFFFFFBFFFFFFBFFFFFFFFFFFFFFFFFFFFFFFFFFFG
GFFFFFFFFFFFFFFFFFFFFFFFFFFBFFFFFFFFBFFFFFFFFFFFFFFFFFFFFFFFFFFG
GFFFFFFFFFFFFFFFFFFFFFFFFFBFFFFFFFFFFBFFFFFFFFFFFFFFFFFFFFFFFFFG
GFFFFFFFFFFFFFFFFFFFFFFFFBFFFFFFFFFFFFBFFFFFFFFFFFFFFFFFFFFFFFFG
GFFFFFFFFFFFFFFFFFFFFFFFBFFFFFFFFFFFFFFBFFFFFFFFFFFFFFFFFFFFFFFG
GFFFFFFFFFFFFFFFFFFFFFFBFFFFFFFFFFFFFFFFBFFFFFFFFFFFFFFFFFFFFFFG
GFFFFFFFFFFFFFFFFFFFFFBFFFFFFFFFFFFFFFFFFBFFFFFFFFFFFFFFFFFFFFFG
GFFFFFFFFFFFFFFFFFFFFBFFFFFFFFFFFFFFFFFFFFBFFFFFFFFFFFFFFFFFFFFG
GFFFFFFFFFFFFFFFFFFFBFFFFFFFFFFFFFFFFFFFFFFBFFFFFFFFFFFFFFFFFFFG
GFFFFFFFFFFFFFFFFFFBFFFFFFFFFFFFFFFFFFFFFFFFBFFFFFFFFFFFFFFFFFFG
GFFFFFFFFFFFFFFFFFBFFFFFFFFFFFFFFFFFFFFFFFFFFBFFFFFFFFFFFFFFFFFG
GFFFFFFFFFFFFFFFFBFFFFFFFFFFFFFFFFFFFFFFFFFFFFBFFFFFFFFFFFFFFFFG
GFFFFFFFFFFFFFFFBBBBBBBBBBBBBBBBBBBBBBBBBBBBBBBBFFFFFFFFFFFFFFFG
GFFFFFFFFFFFFFFGFFFFFFFFFFFFFFFFFFFFFFFFFFFFFFFFGFFFFFFFFFFFFFFG
GFFFFFFFFFFFFFGGFFFFFFFFFFFFFFFFFFFFFFFFFFFFFFFFGGFFFFFFFFFFFFFG
GFFFFFFFFFFFFGFGFFFFFFFFFFFFFFFFFFFFFFFFFFFFFFFFGFGFFFFFFFFFFFFG
GFFFFFFFFFFFGFFGFFFFFFFFFFFFFFFFFFFFFFFFFFFFFFFFGFFGFFFFFFFFFFFG
GFFFFFFFFFFGFFFGFFFFFFFFFFFFFFFFFFFFFFFFFFFFFFFFGFFFGFFFFFFFFFFG
GFFFFFFFFFGFFFFGFFFFFFFFFFFFFFFFFFFFFFFFFFFFFFFFGFFFFGFFFFFFFFFG
GFFFFFFFFGFFFFFGFFFFFFFFFFFFFFFFFFFFFFFFFFFFFFFFGFFFFFGFFFFFFFFG
GFFFFFFFGFFFFFFGFFFFFFFFFFFFFFFFFFFFFFFFFFFFFFFFGFFFFFFGFFFFFFFG
GFFFFFFGFFFFFFFGFFFFFFFFFFFFFFFFFFFFFFFFFFFFFFFFGFFFFFFFGFFFFFFG
GFFFFFGFFFFFFFFGFFFFFFFFFFFFFFFFFFFFFFFFFFFFFFFFGFFFFFFFFGFFFFFG
GFFFFGFFFFFFFFFGFFFFFFFFFFFFFFFFFFFFFFFFFFFFFFFFGFFFFFFFFFGFFFFG
GFFFGFFFFFFFFFFGFFFFFFFFFFFFFFFFFFFFFFFFFFFFFFFFGFFFFFFFFFFGFFFG
GFFGFFFFFFFFFFFGFFFFFFFFFFFFFFFFFFFFFFFFFFFFFFFFGFFFFFFFFFFFGFFG
GFGFFFFFFFFFFFFGFFFFFFFFFFFFFFFFFFFFFFFFFFFFFFFFGFFFFFFFFFFFFGFG
GGFFFFFFFFFFFFFGFFFFFFFFFFFFFFFFFFFFFFFFFFFFFFFFGFFFFFFFFFFFFFGG
GGFFFFFFFFFFFFFGFFFFFFFFFFFFFFFFFFFFFFFFFFFFFFFFGFFFFFFFFFFFFFGG
GFGFFFFFFFFFFFFGFFFFFFFFFFFFFFFFFFFFFFFFFFFFFFFFGFFFFFFFFFFFFGFG
GFFGFFFFFFFFFFFGFFFFFFFFFFFFFFFFFFFFFFFFFFFFFFFFGFFFFFFFFFFFGFFG
GFFFGFFFFFFFFFFGFFFFFFFFFFFFFFFFFFFFFFFFFFFFFFFFGFFFFFFFFFFGFFFG
GFFFFGFFFFFFFFFGFFFFFFFFFFFFFFFFFFFFFFFFFFFFFFFFGFFFFFFFFFGFFFFG
GFFFFFGFFFFFFFFGFFFFFFFFFFFFFFFFFFFFFFFFFFFFFFFFGFFFFFFFFGFFFFFG
GFFFFFFGFFFFFFFGFFFFFFFFFFFFFFFFFFFFFFFFFFFFFFFFGFFFFFFFGFFFFFFG
GFFFFFFFGFFFFFFGFFFFFFFFFFFFFFFFFFFFFFFFFFFFFFFFGFFFFFFGFFFFFFFG
GFFFFFFFFGFFFFFGFFFFFFFFFFFFFFFFFFFFFFFFFFFFFFFFGFFFFFGFFFFFFFFG
GFFFFFFFFFGFFFFGFFFFFFFFFFFFFFFFFFFFFFFFFFFFFFFFGFFFFGFFFFFFFFFG
GFFFFFFFFFFGFFFGFFFFFFFFFFFFFFFFFFFFFFFFFFFFFFFFGFFFGFFFFFFFFFFG
GFFFFFFFFFFFGFFGFFFFFFFFFFFFFFFFFFFFFFFFFFFFFFFFGFFGFFFFFFFFFFFG
GFFFFFFFFFFFFGFGFFFFFFFFFFFFFFFFFFFFFFFFFFFFFFFFGFGFFFFFFFFFFFFG
GFFFFFFFFFFFFFGGFFFFFFFFFFFFFFFFFFFFFFFFFFFFFFFFGGFFFFFFFFFFFFFG
GFFFFFFFFFFFFFFGFFFFFFFFFFFFFFFFFFFFFFFFFFFFFFFFGFFFFFFFFFFFFFFG
GFFFFFFFFFFFFFFFBBBBBBBBBBBBBBBBBBBBBBBBBBBBBBBBFFFFFFFFFFFFFFFG
GFFFFFFFFFFFFFFFFBFFFFFFFFFFFFFFFFFFFFFFFFFFFFBFFFFFFFFFFFFFFFFG
GFFFFFFFFFFFFFFFFFBFFFFFFFFFFFFFFFFFFFFFFFFFFBFFFFFFFFFFFFFFFFFG
GFFFFFFFFFFFFFFFFFFBFFFFFFFFFFFFFFFFFFFFFFFFBFFFFFFFFFFFFFFFFFFG
GFFFFFFFFFFFFFFFFFFFBFFFFFFFFFFFFFFFFFFFFFFBFFFFFFFFFFFFFFFFFFFG
GFFFFFFFFFFFFFFFFFFFFBFFFFFFFFFFFFFFFFFFFFBFFFFFFFFFFFFFFFFFFFFG
GFFFFFFFFFFFFFFFFFFFFFBFFFFFFFFFFFFFFFFFFBFFFFFFFFFFFFFFFFFFFFFG
GFFFFFFFFFFFFFFFFFFFFFFBFFFFFFFFFFFFFFFFBFFFFFFFFFFFFFFFFFFFFFFG
GFFFFFFFFFFFFFFFFFFFFFFFBFFFFFFFFFFFFFFBFFFFFFFFFFFFFFFFFFFFFFFG
GFFFFFFFFFFFFFFFFFFFFFFFFBFFFFFFFFFFFFBFFFFFFFFFFFFFFFFFFFFFFFFG
GFFFFFFFFFFFFFFFFFFFFFFFFFBFFFFFFFFFFBFFFFFFFFFFFFFFFFFFFFFFFFFG
GFFFFFFFFFFFFFFFFFFFFFFFFFFBFFFFFFFFBFFFFFFFFFFFFFFFFFFFFFFFFFFG
GFFFFFFFFFFFFFFFFFFFFFFFFFFFBFFFFFFBFFFFFFFFFFFFFFFFFFFFFFFFFFFG
GFFFFFFFFFFFFFFFFFFFFFFFFFFFFBFFFFBFFFFFFFFFFFFFFFFFFFFFFFFFFFFG
GFFFFFFFFFFFFFFFFFFFFFFFFFFFFFBFFBFFFFFFFFFFFFFFFFFFFFFFFFFFFFFG
GFFFFFFFFFFFFFFFFFFFFFFFFFFFFFFBBFFFFFFFFFFFFFFFFFFFFFFFFFFFFFFG
BBBBBBBBBBBBBBBBBBBBBBBBBBBBBBBBBBBBBBBBBBBBBBBBBBBBBBBBBBBBBBBB